#####################
#   #       # #   # #
# ### ### ### ### # #
# #     #           #
# ### ##### ##### ###
#         #   # # # #
# # ######### # # # #
# #   #     # #     #
# # ### ######### # #
# #           #   # #
# # # # ##### # ### #
# # # #     # # #   #
# ##### ####### ### #
#   # #       #   # #
##### ##### ### # ###
#  K#     #   # # # #
# ### ##### ### ### #
# #     #   #   # D #
# ##### ### ### # # #
#           #     #E#
#####################
